20 20 5
********************
*  * ** *          *
* * *  ***   **  * *
** ***   * *    ****
* *    ****     ****
* * * ** **     ****
*        * *    *  *
*  * * ** *** ******
* *  **** *   *  ***
*     *  *  ** *   *
* *       *  *    **
*** *  *  * **     *
*    *   *    *  ***
* * * ***        * *
*   *    *  *     **
*   **      **    **
*  *   **   *      *
*   *        *  ** *
*            ***   *
********************
